1111111
10C0001
10CC001
10E0001
1111111