1111111
10C0P01
10CC001
10E0001
1111111