111111111111111
111111111E11111
111CCC00000P111
100000000000001
100000000000001
100000000000001
100000000000001
111111111111111