1111111111
1000000001
1111111101
1CCC0000P1
1111111111